v,v,v,v,v,v,v,v,v,v,v,v,v,v,v,v,v,v,v,v,v
v,v,v,v,v,v,v,v,v,v,v,v,v,v,v,v,v,v,v,v,v
v,v,v,v,v,v,v,v,v,w,w,w,w,v,v,v,v,v,v,v,v
v,v,v,v,v,v,v,v,w,w,f,f,w,v,v,v,v,v,v,v,v
v,v,v,v,v,v,v,v,w,x,b,f,w,v,v,v,v,v,v,v,v
v,v,v,v,v,v,v,v,w,w,b,f,w,w,v,v,v,v,v,v,v
v,v,v,v,v,v,v,v,w,w,f,b,f,w,v,v,v,v,v,v,v
v,v,v,v,v,v,v,v,w,g,b,f,f,w,v,v,v,v,v,v,v
v,v,v,v,v,v,v,v,w,g,g,bg,g,w,v,v,v,v,v,v,v
v,v,v,v,v,v,v,v,w,w,w,w,w,w,v,v,v,v,v,v,v