v,v,v,v,v,v,v,v,v,v,v,v,v,v,v,v,v,v,v,v,v
v,v,v,v,v,w,w,w,w,w,v,v,v,v,v,v,v,v,v,v,v
v,v,v,v,v,w,f,pt,f,w,v,v,v,v,v,v,v,v,v,v,v
v,v,v,v,v,w,b,f,f,w,v,v,v,v,v,v,v,v,v,v,v
v,v,v,w,w,w,f,f,b,w,w,v,v,v,v,v,v,v,v,v,v
v,v,v,w,f,f,b,f,b,f,w,v,v,v,v,v,v,v,v,v,v
v,w,w,w,f,w,f,w,w,f,w,v,v,v,w,w,w,w,w,w,v
v,w,f,f,f,w,f,w,w,f,w,w,w,w,w,f,f,g,g,w,v
v,w,f,b,pt,f,b,f,f,f,f,f,f,f,f,f,f,g,g,w,v
v,w,w,w,w,w,f,w,w,w,f,w,x,w,w,f,f,g,g,w,v
v,v,v,v,v,w,f,f,f,f,f,w,w,w,w,w,w,w,w,w,v
v,v,v,v,v,w,w,w,w,w,w,w,v,v,v,v,v,v,v,v,v
v,v,v,v,v,v,v,v,v,v,v,v,v,v,v,v,v,v,v,v,v