v,v,v,v,v,v,v,v,v,v,v,v,v,v,v,v,v,v,v,v,v
v,v,v,v,v,w,w,w,w,v,v,v,v,v,v,v,v,v,v,v,v
v,v,v,v,v,w,g,g,w,v,v,v,v,v,v,v,v,v,v,v,v
v,v,v,v,v,w,g,g,w,w,w,v,v,v,v,v,v,v,v,v,v
v,v,v,v,v,w,g,g,f,f,w,w,w,w,w,v,v,v,v,v,v
v,v,v,v,v,w,g,g,f,f,f,f,f,f,w,v,v,v,v,v,v
v,v,v,v,v,w,w,w,f,w,f,w,f,f,w,w,w,v,v,v,v
v,v,v,v,v,v,v,w,f,f,f,w,b,f,f,f,w,v,v,v,v
v,v,v,v,v,v,v,w,w,f,f,f,b,b,b,f,w,w,v,v,v
v,v,v,v,v,v,v,v,w,w,f,f,b,f,f,b,f,w,v,v,v
v,v,v,v,v,v,v,v,v,w,w,f,b,f,f,b,x,w,v,v,v
v,v,v,v,v,v,v,v,v,v,w,w,w,f,f,w,w,w,v,v,v
v,v,v,v,v,v,v,v,v,v,v,v,w,w,w,w,v,v,v,v,v