v,v,v,v,v,v,v,v,v,v,v,v,v,v
v,v,v,v,v,v,v,v,v,v,v,v,v,v
v,v,v,v,v,v,v,v,v,v,v,v,v,v
v,v,v,v,v,v,v,w,w,w,w,w,w,v
v,v,v,v,v,w,w,w,f,f,f,f,w,v
v,v,v,v,w,w,g,f,b,w,w,f,w,w
v,v,v,v,w,g,g,b,f,b,f,f,x,w
v,v,v,v,w,g,g,f,b,f,b,f,w,w
v,v,v,v,w,w,w,w,w,w,f,f,w,v
v,v,v,v,v,v,v,v,v,w,w,w,w,v